01A00010000100B
010111111101011
010100000101001
010001010001101
011101010100101
000001010110101
111101000010001
000101101000100
110100101011111
010110000000100
000011011110001
101001001011101
101011101000001
001000001011011
B1110110001000B